*************************** *********
*               *** ***  ** ***   ***
* ***  ** ***   *** ***  ** ***   ***
* ***  *****        ***  *****      *
* **      **      * ***  ** ***   ***
*         ** ***       * ** * * *  **
* *****        *       * ** * * *  **
* *   *        *       * ** * * *  **
* **  * ** * * *       * ** * * *  **
*       **             * ** * * *  **
*  ****   **   *              * *  **
*              **      * ** * * *  **
***  ** **   ******    * ** * * *  **
* *   **** *   *       * ** * * *  **
* **  *    *           * ** * * *  **
*     *    * ***       * ** * * *  **
*************************************
