*******************
*0              **
* ***  ** ***   ***
* ***  *****      *
* **      **      *
*         ** ***  *
* *****        *  *
* *   *        *  * 
* **  * ** * * *  *
*       **        *
*  ****   **   *  *
*              ** *
***  ** **   ******
* *   **** *   *  *
* **  *    *      *
*     *    * ***  *
* *****  ***   *  *
* *   *    *   *  * 
* *   *  *******  *
*        * **     *
*  ****    * **** *
*   **     *   *  *
***  ***** * ******
*     **          *
*** ****** ***** **
**  * ** *  *     *
*** *    *  *    1*
*** *    *  *******
*   ** * ** **  ***
*      *          *
*******************
